<?php
/*
 *  This file is part of IIIF Manifest Creator.
 *
 *  IIIF Manifest Creator is free software: you can redistribute it and/or modify
 *  it under the terms of the GNU General Public License as published by
 *  the Free Software Foundation, either version 3 of the License, or
 *  (at your option) any later version.
 *
 *  IIIF Manifest Creator is distributed in the hope that it will be useful,
 *  but WITHOUT ANY WARRANTY; without even the implied warranty of
 *  MERCHANTABILITY or FITNESS FOR A PARTICULAR PURPOSE.  See the
 *  GNU General Public License for more details.
 *
 *  You should have received a copy of the GNU General Public License
 *  along with IIIF Manifest Creator.  If not, see <http://www.gnu.org/licenses/>.
 *
 *  @category IIIF\PresentationAPI
 *  @package  Parameters
 *  @author   Harry Shyket <harry.shyket@yale.edu>
 *  @license  http://opensource.org/licenses/gpl-2.0.php GNU General Public License
*/
namespace IIIF\PresentationAPI\Parameters;

/**
 * Values used throughout the specification documentation
 *
 */
class Identifier {

    const ATTRIBUTION       = "attribution";
    const ATVALUE           = "@value";
    const CANVASES          = "canvases";
    const COLLECTIONS       = "collections";
    const CONTENTLAYER      = "contentLayer";
    const CONTEXT		        = "@context";
    const DESCRIPTION       = "description";
    const FORMAT            = "format";
    const FORMATS           = "formats";
    const HEIGHT            = "height";
    const ID				        = "@id";
    const IMAGES            = "images";
  	const LABEL			        = "label";
  	const LANG              = "@lang";
  	const LANGUAGE          = "@language";
  	const LICENSE           = "license";
  	const LOGO              = "logo";
    const MANIFESTS         = "manifests";
    const MAXAREA           = "maxArea";
    const MAXHEIGHT         = "maxHeight";
    const MAXWIDTH          = "maxWidth";
    const MEMBERS           = "members";
  	const METADATA          = "metadata";
  	const MOTIVATION        = "motivation";
  	const NAVDATE           = "navDate";
  	const ON                = "on";
  	const OTHERCONTENT      = "otherContent";
    const PROFILE           = "profile";
    const PROTOCOL          = "protocol";
    const QUALITIES         = "qualities";
    const RANGES            = "ranges";
    const RELATED           = "related";
    const RENDERING         = "rendering";
    const RESOURCE          = "resource";
    const RESOURCES         = "resources";
    const SCALEFACTORS      = "scaleFactors";
    const SEEALSO           = "seeAlso";
    const SEQUENCES         = "sequences";
    const SERVICE           = "service";
    const SIZES             = "sizes";
    const STARTCANVAS       = "startCanvas";
    const STRUCTURES        = "structures";
    const SUPPORTS          = "supports";
  	const THUMBNAIL         = "thumbnail";
  	const TILES             = "tiles";
  	const TOTAL             = "total";
  	const TYPE              = "@type";
  	const VALUE             = "value";
  	const VIEWINGDIRECTION  = "viewingDirection";
  	const VIEWINGHINT       = "viewingHint";
  	const WIDTH             = "width";
  	const WITHIN            = "within";

}
